NO textures/wall.cubtxt



SO textures/wall.cubtxt
WE textures/wall.cubtxt
EA textures/wall.cubtxt

F 0,0,0

C 0,0,0
1111111111111111111111111
1000000000110000000000001
1011000001110000000N00001
1001000000000000000000001
1111111111111111111111111