NO textures/nuitetoilee.cubtxt



SO textures/lecri.cubtxt
WE textures/nuitetoilee.cubtxt
EA textures/joconde.cubtxt

C 30,232,250

F 46,5,5
111111111111111111111111111111111111111111111111111111111
100001000000000000000000000000000100000100000000000000001
100001000000000000000000000001000000000100000000000000001
11111100001000000000N000000000000001000111110000000000001
100001000000000000000000000001000000000100000000000000001
100001000000000000000000100001001000010110000000000000001
100001000000011110000000000001000000000000000000000000001
10000000000001  10000000000001000000000000000000000000001
10000000000001  10000000100001000010000000000000000000001
10000000000001  10000000000000000000010000001111111111111
10000000000001  10100100000001000000000100001
10001100000001  10000100000000000000000100001
10000000001001  10000100100000000001000100001
10000000000001  10000100001111110000000100001
10000000000001  10000100000000000000000000001
100001000000011110000010000000000010000000001
100000000000000000000000000000000000000000001
100000000001111100000000000010000000000000001
100010000000000000000000000000000100000000001
100000000000000000000000000000000000001000001
100000000000010000000000001000000000000000001
100000000000000000100000000000000000000000001
100000000000000000100000000000000100000000001
100000000000010000100010000000000000000000001
100000000000000000100000000000000001000000001
100000010000000000000000000000000000000000001
100000000000000000000000000000000000000000001
111111111111111111111111111111111111111111111