NO textures/nuitetoilee.cubtxt



SO textures/lecri.cubtxt
WE textures/nuitetoilee.cubtxt
EA textures/joconde.cubtxt

C 240,176,98

F 46,5,5
111111111111111111111111111111111111111111111
100001000000000000000000000000000100000100001
100001000000000000000000000001000000000100001
11111100001000000000E000000000000001000111111
100001000000000000000000000001000000000100001
100001000000000000000000100001001000010110001
100001000000011110000000000001000000000000001
10000000000001  10000000000001000000000000001
100000000000011110000000100001000010000000001
100000000000000000000000000000000000010000001
100000000000000000100100000001000000000100001
100011000000000000000100000000000000000100001
100000000010000000000100100000000001000100001
100000000000000000000100001111110000000100001
100000000000000000000100000000000000000000001
100001000000000000000010000000000010000000001
100000000000000000000000000000000000000000001
100000000001111100000000000010000000000000001
100010000000000000000000000000000100000000001
100000000000000000000000000000000000001000001
100000000000010000000000001000000000000000001
100000000000000000100000000000000000000000001
100000000000000000100000000000000100000000001
100000000000010000100010000000000000000000001
100000000000000000100000000000000001000000001
100000010000000000000000000000000000000000001
100000000000000000000000000000000000000000001
111111111111111111111111111111111111111111111